19 3
 B 2 2   2   2B  4 
 #3# # # # # #2#3# 
3 B      1 12 44   
 # #3# # # # # # # 
B3B 33   3   0   0 
 #3#2# # #B#0#0# # 
B3B B3  33  000B 0 